{
  "width": 20,
  "height": 20,
  "player": { "x": 10, "y": 10 },
  "map": [
    "####################",
    "#                  #",
    "#                  #",
    "#                  #",
    "#                  #",
    "#                  #",
    "#                  #",
    "#                  #",
    "#      @####       #",
    "#       #  #       #",
    "#        $ #       #",
    "#         #        #",
    "#      #####       #",
    "#                  #",
    "#         .        #",
    "#                  #",
    "#                  #",
    "#                  #",
    "#                  #",
    "####################"
  ]
}
