{
  "width": 20,
  "height": 20,
  "player": { "x": 2, "y": 2 },
  "map": [
    "####################",
    "#                  #",
    "# @                #",
    "#    ###########   #",
    "#         $  $ #   #",
    "#    ##        #   #",
    "#    ###########   #",
    "#                  #",
    "#                  #",
    "#                  #",
    "#       .          #",
    "#                  #",
    "#                  #",
    "#                  #",
    "#            .     #",
    "#                  #",
    "#                  #",
    "#                  #",
    "#                  #",
    "####################"
  ]
}
